44
35
11111111111111111111111111111111111111111011
11111111111111111111111111111111111111111011
11000000000000000000100000000000011111101011
11011111111111111110101110111111000000001011
11010101000000001010101010110001111111111011
11010000000000001010101010000000000000000011
11010000110000001010000010110001111111110011
11010000010000001010101110111111000000011111
11010000010111000010101000000111000111000011
11010000110100011010101000000000000100011011
11010000000101110010101111111111111101111011
11010101000001000110100000000000000001000011
11011111000111010010101111111111111101000011
11010011111100010110100010000010010001000011
11010010000001010010101010100010010101000011
11010110110111111110101000100010000101111111
11010000100000000000101111100010010100000011
11011111101111111111101000100011110101111011
11000000000000000000001000100000000101111111
11111111101111111110111000111111110100000011
11100000101000000100011000000001010100000011
11100000101000000100000000000000000001111111
11100000100001100100011110111101011100110011
11100000101001100111110000000001010110010111
11101111101000000100010010111101010111000111
11100000001000000000000110111101011111111111
11111101011111101111111100011101000000001111
11000001010000100010000101011101000000001111
11011101011111111000010100010001000000000011
11000101000000000010010001000101000000001011
11000111111110111111111111111111000000001011
11000000000000000000000000000011000000001011
11111111111111111111111111111011000000001011
11111111111111111111111111111011111111111111
11111111111111111111111111111011111111111111
